111111111111111111111111111111111111
1C0000000000C00000C000100100101C00E1
1011110C000001111110001101C010100001
1000P0001111000C000010C0000011100C01
100C000010C0000000001000C0000C001001
111111111111111111111111111111111111
