1111111111111111111111111111111111111111
1000000000000000100000000000000000000001
1000000000C00000100000010000000111111111
1111111000000000100000010000000100000001
10000000000001111000000000C0000111110001
1000000P00000000000000000000000000000001
1000000C0000000000C000000000000000000001
1000000E000001000000000000000000000C0001
1000000100000100000000000000000000000001
1000000100000100000011111000000111110001
100000010000000000000000000C000000000001
100000110000C000000000000000000000000001
10000010000000000000000C0000000001000001
1000001000001111100000100000000001000001
1000000000000000000000100000000001000001
100000000C000000000000100000000001000011
1000000111111111000000000011011101000001
1000000000000000000C00001000000000000001
10000000000000000000000010000000E0000001
1000000000000000000000000000000000000001
1111111111111111111111111111111111111111
