111111111111111111111111111111111111
1C1000000000C00000C000100100101C01E1
1011110C000001111110001101C010100101
1010P0001111000C000010C0000011100C11
101C000010C0000000001000C0000C001001
111111111111111111111111111111111111
