111111111111111111111111111111111111
1C0000000000C00000C000100100101C01E1
1001110C000001111110001101C010100101
1000P0001111000C000010C0000011100C11
100C000010C0000000001000C0000C011001
111111111111111111111111111111111111
